NO ./path_to_the_north_texture
SO ./path_to_the_south_texture
WE ./path_to_the_west_texture
EA ./path_to_the_east_texture

C 53,81,92
F 52,140,49

11111111111
10000000001
10110000011
10010010001
10010N00001
11000000111111111111111111111
10000000000000001100000000001
10000000000000000001010000001
10000001110101011111111110001
10000001 1010101        10001
11111111 1111111        11111