NO ./textures/brick.xpm
SO ./textures/metal.xpm
WE ./textures/stone.xpm
EA ./textures/wood.xpm

C 53,81,92
F 52,1140,49

  11111111111
  10000000S01
  10110000011
  10010010001
  10010000001
11100000000111111111111111111
10011100000000001100000000001
1001 100000000000001010000001
10011101110101011111111110001
10000001 1010101        10001
11111111 1111111        11111