NO ./path_to_the_north_texture
SO ./path_to_the_south_texture
WE ./path_to_the_west_texture
EA ./path_to_the_east_texture

F 220,100,5
C 225,30,10

11111111111
10000000001
10110000011
10010010001
10010000001
11000000111111111111111111111
10000000000000001100000000001
10000000000000000001010000001
10000001110101011111111110N01
10000001 1110101        10001
11111111 1111111        11111