NO ./textures/wall1.xpm
SO ./textures/wall2.xpm
WE ./textures/wall3.xpm
EA ./textures/wall4.xpm

C 53,81,190
F 52,140,49

  11111111111
  10000000001
  10110000011
  10010010001
  10010000001
11100000000111111111111111111
10011100000000001100000000001
1001 10000N000000001010000001
10011101110101011111111110001
10000001 1010101        10001
11111111 1111111        11111